#############·····························
#·····#··A·······························#
#@###·#·###······························#
#·····o··································#
#·###·#·###······························#
#A···A#····@·····························#
#############·····························