#############
#·····#··A··#
#@###·#·###·#
······o······
#·###·#·###·#
#A···A#····@#
#############